Account – аккаунт/учетная запись.

Account preferences – настройки учетной записи.

Actual result – фактический результат.

Additional information – дополнительная информация.

Application crash — экстренное завершение работы приложения.

Attached files – прикрепленные файлы.

Аuthorization – авторизация.

Authentication – аутентификация.

Bug report – баг-репорт/дефект/отчет об ошибке.

Checkbox – чекбокс (флаговая кнопка).

Click the button/link – нажать кнопкой мыши на кнопку/ссылку.

Close the window – закрыть окно.

Create an account – создать аккаунт.

Combo box/drop-down list – раскрывающийся список.

Сurrent/new password – текущий/новый пароль.

Default cursor – курсор по умолчанию.

Drop-down menu – выпадающее меню.

Edit field – поле редактирования.

E-mail – электронный адрес.

Error message – сообщение об ошибке.

Expected result – ожидаемый результат.

Favicon – иконка веб-сайта.

Fill in required fields – заполнить обязательные поля.

Highlight – подсвечивать.

Home/main page – главная страница сайта.

Hover the mouse over… – навести курсор мыши на…

Landscape mode – ландшафтный режим.

Launch the application/game – запустить приложение/игру.

Log in/Log out – ввойти в систему (авторизоваться)/выйти из системы.

Look at the – посмотрите на.

Navigation menu – навигационное меню.

Open the site – открыть сайт.

Overlap – перекрывать/накладываться.

Pay attention to the – обратить внимание на.

Pinch in/out – увеличение/уменьшение размера на сенсорном экране.

Placeholder – плейсхолдер (это переменные, которыми можно заменить в тексте определенное содержимое: названия, числа, даты, изображения и т. д, они используются при локализации программ, игр и сайтов)

Рop-up window – всплывающее окно.

Portrait mode – портретный режим.

Press the button – нажать на кнопку на клавиатуре.

Priority (low, medium, high) – приоритет (низкий, средний, высокий).

Radio-button – кнопка-переключатель.

Registration – регистрация.

Refresh the page – обновить страницу.

Reporter – докладчик/инициатор.

Report issue – создать отчет об ошибке.

Reproducibility (always, sometimes, random, have not tried, unable to reproduce, n/a) – воспроизводимость (всегда, иногда, произвольно, не проверялась, не воспроизводится, неприменимо).

Rotate the device – повернуть устройство.

Rotate left/right – переворот пальцами на сенсорном экране против/по часовой стрелке.

Scrollbar – полоса прокрутки.

Scroll up/down the page – прокрутить страницу вверх/вниз.

Severity (trivial, text, tweak, minor, major, crash, block) – серьезность (тривиальная, незначительная, значительная, малая, большая, критическая, блокирующая).

Sharing – поделиться в соц. сетях.

Sign in – войти в систему.

Sign up for – зарегистрироваться.

Sign out – выйти из системы.

Slider – слайдер/ползунок.

Social media links – ссылки социальных сетей.

Spread – растянуть на сенсорном экране.

Steps to reproduce – шаги по воспроизведению.

«Submit» button – кнопка «Отправить», «Подтвердить»
Swipe left/right/up/down – пролистать на сенсорном экране влево/вправо/вверх/вниз.

Tap – нажатие на сенсорном экране.

Textbox – текстовое поле.

Title/header – заголовок.

Tooltip/hint – всплывающая подсказка.

Update the information – обновить информацию.

Valid/invalid data – валидные/невалидные данные.

Zoom in/out – увеличение/уменьшение размера.

- CRUD - Create,Read,Update, Delete - четыре базовые функции, используемые при работе с базами данных. Да и часто употребляется в описании permissions для юзеров, особенно в требованиях. 
- Portrait/Landscape mode – портретный\ландшафтный режим, или книжная/альбомная ориентация экрана
 - Pay attention to the – обратить внимание на… 
- Reproducibility (always, sometimes, random, have not tried, unable to reproduce, n/a) – воспроизводимость (всегда, иногда, произвольно, не проверялась, не воспроизводится, неприменимо). 
- Severity (trivial, text, tweak, minor, major, crash, block) – серьезность дефекта, насколько он "ломает" систему (тривиальная, незначительная, значительная, малая, большая, критическая, блокирующая).
 - Tooltip/hint – всплывающая подсказка.
 - Validation — определение соответствия разрабатываемого ПО ожиданиям и потребностям пользователя, требованиям к системе.(разрабатываем ли мы то, что нужно юзеру?) 
- Verification — процесс оценки системы или её компонентов с целью определения удовлетворяют ли результаты текущего этапа разработки условиям, сформированным в начале этого этапа.(соответствует ли то, что мы разрабатываем, требованиям(requirements)?)

Back-end — ПО и данные, находящиеся за фасадом фронт-энда: HTML-код веб-страницы, код приложения и т.д.

Bug Tracking System — баг-трекинговая система

Code inspection — инспекция кода

Draft — черновик

Error message — сообщение об ошибке

Feature request ("запрос об улучшении") — "баг" рационализаторского плана

File a bug — рапортавать баг

Front-end — это непосредственный интерфейс пользователя, т.е. текст, картинки, кнопки, линки и прочие вещи, которые видит пользователь

Functional bug — функциональный баг

Logical bug — логический баг

Maintainability — поддерживаемость, т.е. насколько легко и просто можно изменить тест-кейс при изменениях в ПО

Negative testing — "негативное" тестирование - это тестирование на данных или сценариях, которые соответствуют нештатному поведению тестируемой системы - различные сообщения об ошибках, исключительные ситуации, "запредельные" состояния и т.д.

New feature testing — тестирование новых компонентов

Null input — пустой ввод

Performance testing — тестирование скорости работы всей системы либо ее компонента

Positive testing — "позитивное" тестирование - это тестирование на данных или сценариях, которые соответствуют нормальному (штатному, ожидаемому) поведению тестируемой системы

Regression testing — регрессивное тестирование

Required fields — обязательные поля

Release ("релиз") — передача ПО пользователю

Классификация "релизообразных":
Релиз (он же основной релиз) (major release) — стадия в цикле разработки ПО,идущая за стадией тестирования и ремонта багов, т.е. передача пользователям кода новой версии нашего ПО. Как правило, обозначается целыми числами, например 7.0.
Дополнительный релиз (minor release) — ситуация, когда после основного релиза планово выпускается новая функциональность или изменяется/удаляется старая. Дополнительный релиз не связан в багами. Как правило, обозначается десятыми, например 7.1.
Заплаточный релиз (patch release), когда после обнаружения и ремонта бага выпускается исправленный код. Как правило, обозначается сотыми, например 7.11. release candidate — сборка-кандидат на релиз

Retired — более недействителен

Retired test cases — недействительные тест-кейс

Revision history — история редактирования

Setup and additional info — подготовительная часть

Smoke test, sanity test or confidence test — тест приемки (в процессе которого проверяются основные функциональности)

Software development life cycle — (процесс) разработки ПО — это путь от идеи до поддержки готового продукта.

Spec bug — баг в спецификации

Syntax bug — синтаксический баг

Test case — тест-кейс - это артефакт, описывающий совокупность шагов, конкретных условий и параметров, необходимых для проверки реализации тестируемой функции или её части.

Test case suite — тест-комплекты, совокупность тест-кейсов

Test case generation — создание тест-кейса

Test case execution — исполнение тест-кейса

Test case result — исход исполнения тест-кейса

Test case priority — приоритет тест-кейса

Test-coverage — это одна из метрик оценки качества тестирования, представляющая из себя плотность покрытия тестами требований либо исполняемого кода.

Test design — это этап процесса тестирования ПО, на котором проектируются и создаются тестовые случаи (тест кейсы), в соответствии с определёнными ранее критериями качества и целями тестирования.

Test framing — обоснование тестов

Testcase review — рассмотрение тест-кейсов

Test plan — это документ, описывающий весь объем работ по тестированию, начиная с описания объекта, стратегии, расписания, критериев начала и окончания тестирования, до необходимого в процессе работы оборудования, специальных знаний, а также оценки рисков с вариантами их разрешения.

Unit-testing — юнит-тестирование - это тестирование, производимое самим программистом

Valid input — ввод действительных значений

